'A	AA
'BOUT	B AW T
'CAUSE	K AH Z
'CAUSED	K EY AH S T
'CEPT	S EH P T
'EM	AH M
'FORGET	F AO R JH AH T
'FRISCO	F R IH S K OW
'HEAD	HH IY D
'L'	EH L
'LONE	L OW N
'NEATH	N IY TH
'NO'	N AA
'ROUND	R AW N D
'SURE	S UH R
'TIL	T IH L
'TILL	T IH L
A	AH
A	EY
AAAAAAA	AA AA AH AH
AAAAAAAAAAAAAAA	AH AH AA AH AH AA AH AH
AAAAAH	AA AH AH
AAAAHHHH	AA AH HH
AAAH	AA AH
AAH	AA
ABOOOOOOVE	AE B UW UW UW V
ABOUT	AH B AW T
ABOVE	AH B AH V
ACCLAMATION	AE K L AH M EY SH AH N
ACHE	EY K
ACHIEVE	AH CH IY V
ACHING	EY K IH NG
ACHY	EY K IY
ACROSS	AH K R AO S
ACT	AE K T
ACTING	AE K T IH NG
ACTION	AE K SH AH N
ADDICTED	AH D IH K T IH D
ADMIT	AH D M IH T
ADORATION	AE D ER EY SH AH N
ADORE	AH D AO R
AE	EY
AFFAIR	AH F EH R
AFFORD	AH F AO R D
AFFRAID	AE F R EY D
AFRAID	AH F R EY D
AFTER	AE F T ER
AGAIN	AH G EH N
AGAIN	AH G EY N
AGE	EY JH
AGO	AH G OW
AH	AA
AHEAD	AH HH EH D
AHH	AA
AIM	EY M
AIN	AH IH N
AIN'T	EY N T
AIR	EH R
ALARMED	AH L AA R M D
ALIVE	AH L AY V
ALL	AO L
ALMOST	AO L M OW S T
ALONE	AH L OW N
ALONG	AH L AO NG
ALREADY	AO L R EH D IY
ALREADY	AO R EH D IY
ALRIGHT	AO L R AY T
ALTHOUGH	AO L DH OW
ALWAYS	AO L W EY Z
ALWAYS	AO L W IY Z
AM	AE M
AM	EY EH M
AMAZING	AH M EY Z IH NG
AMENDS	AH M EH N D Z
AMERICA	AH M EH R IH K AH
AMERICAN	AH M EH R IH K AH N
AMISTAD	AE M AH S T AE D
AMORE	AA M AO R
AN	AE N
AN	AH N
AND	AH N D
AND	AE N D
ANGEL	EY N JH AH L
ANGELS	EY N JH AH L Z
ANIMAL	AE N AH M AH L
ANIMALS	AE N AH M AH L Z
ANOTHER	AH N AH DH ER
ANSWER	AE N S ER
ANSWERS	AE N S ER Z
ANTICIPATION	AE N T IH S AH P EY SH AH N
ANY	EH N IY
ANYBODY	EH N IY B AH D IY
ANYMORE	EH N IY M AO R
ANYONE	EH N IY W AH N
ANYONE'S	EH N IY W AH N Z
ANYTHING	EH N IY TH IH NG
ANYTIME	EH N IY T AY M
ANYWAY	EH N IY W EY
ANYWHERE	EH N IY W EH R
ANYWHERE	EH N IY HH W EH R
APART	AH P AA R T
APOLOGIZE	AH P AA L AH JH AY Z
APPEARED	AH P IH R D
APPLE	AE P AH L
APPRECIATE	AH P R IY SH IY EY T
ARE	AA R
ARE	ER
ARKANSAS	AA R K AH N S AA
ARMS	AA R M Z
AROUND	ER AW N D
AROUND	ER AW N
ARROWS	AE R OW Z
ARROWS	EH R OW Z
ART	AA R T
AS	AE Z
AS	EH Z
ASHAMED	AH SH EY M D
ASIDE	AH S AY D
ASK	AE S K
ASKED	AE S K T
ASKED	AE S T
ASKING	AE S K IH NG
ASKS	AE S K S
ASS	AE S
ASTRAY	AH S T R EY
AT	AE T
ATARI	AH T AA R IY
ATTACKED	AH T AE K T
ATTENTION	AH T EH N SH AH N
ATTITUDE	AE T AH T UW D
AUNT	AE N T
AUNT	AO N T
AWAKE	AH W EY K
AWARE	AH W EH R
AWAY	AH W EY
AWESOME	AA S AH M
AWESOME	AO S AH M
AWFUL	AA F AH L
AWFUL	AO F AH L
B	B IY
BA	B AA
BABE	B EY B
BABY	B EY B IY
BABY'S	B EY B IY Z
BACK	B AE K
BACKLASH	B AE K L AE SH
BACKWARDS	B AE K W ER D Z
BAD	B AE D
BAGS	B AE G Z
BALL	B AO L
BALLS	B AO L Z
BAND	B AE N D
BANG	B AE NG
BANGING	B AE NG IH NG
BANGS	B AE NG Z
BANK	B AE NG K
BANNER	B AE N ER
BAPTISTS	B AE P T AH S T S
BAPTISTS	B AE P T AH S
BAR	B AA R
BARELY	B EH R L IY
BARLEY	B AA R L IY
BARREL	B AE R AH L
BARREL	B EH R AH L
BATTLE	B AE T AH L
BAY	B EY
BE	B IY
BEAR	B EH R
BEARDED	B IH R D AH D
BEARER	B EH R ER
BEAST	B IY S T
BEAT	B IY T
BEATING	B IY T IH NG
BEAUTIFUL	B Y UW T AH F AH L
BEAUTIFULLY	B Y UW T AH F L IY
BEAUTY	B Y UW T IY
BEAUTY'S	B Y UW T IY Z
BECAUSE	B IH K AO Z
BECAUSE	B IH K AH Z
BECAUSE	B IH K AA Z
BECOME	B IH K AH M
BECOMES	B IH K AH M Z
BED	B EH D
BEE	B IY
BEEN	B IH N
BEEN	B AH N
BEER	B IH R
BEES	B IY Z
BEFORE	B IH F AO R
BEFORE	B IY F AO R
BEG	B EH G
BEGAN	B IH G AE N
BEGAN	B IY G AE N
BEGIN	B IH G IH N
BEGINNING	B IH G IH N IH NG
BEGINS	B IH G IH N Z
BEGUN	B IH G AH N
BEGUN	B EY G AH N
BEHIND	B IH HH AY N D
BEIGE	B EY ZH
BEING	B IY IH NG
BELIEEEEEVE	B IH L AY IY IY V
BELIEVE	B IH L IY V
BELIEVER	B IH L IY V ER
BELIEVING	B IH L IY V IH NG
BELL	B EH L
BELLS	B EH L Z
BELONG	B IH L AO NG
BENDING	B EH N D IH NG
BENDS	B EH N D Z
BENEATH	B IH N IY TH
BENEFITS	B EH N AH F IH T S
BESIDE	B IH S AY D
BESIDE	B IY S AY D
BEST	B EH S T
BESTEST	B EH S T AH S T
BET	B EH T
BET'CHA	B IH T AA
BETTER	B EH T ER
BETTEREASE	B EH T ER IY Z
BETTWEEN	B IH T W IY AH N
BETWEEN	B IH T W IY N
BETWEEN	B IY T W IY N
BI	B AY
BIG	B IH G
BIGGER	B IH G ER
BIKINI	B IH K IY N IY
BILL	B IH L
BILLION	B IH L Y AH N
BILLS	B IH L Z
BILLY	B IH L IY
BINGO	B IH NG G OW
BIRD	B ER D
BIRDS	B ER D Z
BIRTHDAY	B ER TH D EY
BIT	B IH T
BITCH	B IH CH
BITCHES	B IH CH IH Z
BITE	B AY T
BITES	B AY T S
BITTERNESS	B IH T ER N AH S
BITTERSWEET	B IH T ER S W IY T
BLACK	B L AE K
BLADE	B L EY D
BLAME	B L EY M
BLANKLY	B L AE NG K L IY
BLASTED	B L AE S T AH D
BLASTED	B L AE S T IH D
BLEED	B L IY D
BLEEDING	B L IY D IH NG
BLESS	B L EH S
BLESSED	B L EH S T
BLIND	B L AY N D
BLINDED	B L AY N D IH D
BLOW	B L OW
BLOWING	B L OW IH NG
BLOWTORCH	B L OW T AO R CH
BLUE	B L UW
BLUES	B L UW Z
BLURRED	B L ER D
BO	B OW
BODY	B AA D IY
BODY'S	B AA D IY Z
BOLD	B OW L D
BOLDER	B OW L D ER
BOMBS	B AA M Z
BONE	B OW N
BONES	B OW N Z
BOO	B UW
BOOTS	B UW T S
BORDERLINE	B AO R D ER L AY N
BORE	B AO R
BORED	B AO R D
BORN	B AO R N
BORROW	B AA R OW
BOTH	B OW TH
BOTTLES	B AA T AH L Z
BOUDOIR	B UW D OY R
BOUGHT	B AA T
BOUGHT	B AO T
BOULEVARD	B UH L AH V AA R D
BOUND	B AW N D
BOW	B AW
BOW	B OW
BOY	B OY
BOYFRIEND	B OY F R EH N D
BOYS	B OY Z
BRAIN	B R EY N
BRAKES	B R EY K S
BRANCHES	B R AE N CH AH Z
BRANCHES	B R AE N CH IH Z
BRAND	B R AE N D
BRASS	B R AE S
BRAVE	B R EY V
BRAVER	B R EY V ER
BREAD	B R EH D
BREAK	B R EY K
BREAKFAST	B R EH K F AH S T
BREAKING	B R EY K IH NG
BREAKS	B R EY K S
BREAKY	B R EY K IY
BREATH	B R EH TH
BREATHE	B R IY DH
BREATHING	B R IY DH IH NG
BRIDGES	B R IH JH AH Z
BRIDGES	B R IH JH IH Z
BRIGHT	B R AY T
BRIGHTLY	B R AY T L IY
BRING	B R IH NG
BRINGING	B R IH NG IH NG
BRINGS	B R IH NG Z
BROAD	B R AO D
BROKE	B R OW K
BROKEN	B R OW K AH N
BROTHER	B R AH DH ER
BROUGHT	B R AO T
BROWN	B R AW N
BUILD	B IH L D
BUILT	B IH L T
BULL	B UH L
BULLET	B UH L AH T
BULLIED	B UH L IY D
BUM	B AH M
BUMPING	B AH M P IH NG
BUNDLED	B AH N D AH L D
BURDENS	B ER D AH N Z
BURN	B ER N
BURNED	B ER N D
BURNING	B ER N IH NG
BURNS	B ER N Z
BURNT	B ER N T
BURSTING	B ER S T IH NG
BUS	B AH S
BUSHELS	B UH SH AH L Z
BUSINESSMEN	B IH Z N IH S M EH N
BUSY	B IH Z IY
BUT	B AH T
BUUURRRN	B Y UW AH AH R N
BUY	B AY
BUYS	B AY Z
BUZZ	B AH Z
BY	B AY
C'MON	K AH M AA N
CAB	K AE B
CAGE	K EY JH
CALL	K AO L
CALLED	K AO L D
CALLING	K AO L IH NG
CALLS	K AO L Z
CAME	K EY M
CAMELOT	K AE M AH L AA T
CAN	K AE N
CAN	K AH N
CAN'T	K AE N T
CANNIBAL	K AE N AH B AH L
CANNOT	K AE N AA T
CANNOT	K AH N AA T
CAP	K AE P
CAPITAL	K AE P IH T AH L
CAR	K AA R
CARDS	K AA R D Z
CARE	K EH R
CARED	K EH R D
CARELESSLY	K EH R L EH S L IY
CARES	K EH R Z
CARNIVAL	K AA R N AH V AH L
CARPET	K AA R P AH T
CARRY	K AE R IY
CARRY	K EH R IY
CARRYING	K AE R IY IH NG
CARRYING	K EH R IY IH NG
CARS	K AA R Z
CARS	K AA Z
CART	K AA R T
CASE	K EY S
CASH	K AE SH
CASTLE	K AE S AH L
CASUAL	K AE ZH AH W AH L
CATCH	K AE CH
CAUGHT	K AA T
CAUGHT	K AO T
CAUSE	K AA Z
CAUSE	K AO Z
CAUSED	K AA Z D
CAUSED	K AO Z D
CAVERN	K AE V ER N
CAVING	K EY V IH NG
CEASAR	S AH S AA R
CELL	S EH L
CENTURY	S EH N CH ER IY
CERTAIN	S ER T AH N
CES	S AH Z
CHA	CH AA
CHAAANGE	CH AA AH N JH
CHAMPAGNE	SH AE M P EY N
CHANCE	CH AE N S
CHANCES	CH AE N S AH Z
CHANCES	CH AE N S IH Z
CHANGE	CH EY N JH
CHANGED	CH EY N JH D
CHANGES	CH EY N JH AH Z
CHANGES	CH EY N JH IH Z
CHANGING	CH EY N JH IH NG
CHAPEL	CH AE P AH L
CHARMS	CH AA R M Z
CHASE	CH EY S
CHASES	CH EY S AH Z
CHASES	CH EY S IH Z
CHASING	CH EY S IH NG
CHEAP	CH IY P
CHEAT	CH IY T
CHECKING	CH EH K IH NG
CHEMICALS	K EH M IH K AH L Z
CHEST	CH EH S T
CHEVY	SH EH V IY
CHEVY	CH EH V IY
CHILD	CH AY L D
CHILDREN	CH IH L D R AH N
CHILDREN'S	CH IH L D R AH N Z
CHILL	CH IH L
CHILLING	CH IH L IH NG
CHILLS	CH IH L Z
CHILLY	CH IH L IY
CHIME	CH AY M
CHIPS	CH IH P S
CHOICE	CH OY S
CHOIR	K W AY ER
CHOLA	CH OW L AH
CHOOSE	CH UW Z
CHOOSING	CH UW Z IH NG
CHORDS	K AO R D Z
CHRIST	K R AY S T
CHRISTMAS	K R IH S M AH S
CIGARETTE	S IH G AH R EH T
CITIES	S IH T IY Z
CITY	S IH T IY
CLAIM	K L EY M
CLARITY	K L EH R AH T IY
CLARITY	K L EH R IH T IY
CLAUS	K L AO Z
CLAW	K L AO
CLEAN	K L IY N
CLEAR	K L IH R
CLEARER	K L IH R ER
CLEVER	K L EH V ER
CLICK	K L IH K
CLIFF	K L IH F
CLIMB	K L AY M
CLIMBED	K L AY M D
CLIMBING	K L AY M IH NG
CLOCK	K L AA K
CLOSE	K L OW S
CLOSE	K L OW Z
CLOSED	K L OW Z D
CLOSER	K L OW S ER
CLOSER	K L OW Z ER
CLOSING	K L OW Z IH NG
CLOTHES	K L OW DH Z
CLOTHES	K L OW Z
CLOUDS	K L AW D Z
CLOUDY	K L AW D IY
CLUB	K L AH B
CO	K OW
COAST	K OW S T
COCAINE	K OW K EY N
COFFEE	K AA F IY
COFFEE	K AO F IY
COLD	K OW L D
COLDER	K OW L D ER
COLLECTION'S	K AH L EH K SH AH N Z
COLLEGE	K AA L IH JH
COLOR	K AH L ER
COLOR	K AO L ER
COLORED	K AH L ER D
COLORS	K AH L ER Z
COMB	K OW M
COME	K AH M
COMES	K AH M Z
COMFORT	K AH M F ER T
COMING	K AH M IH NG
COMMISERATING	K AH M IH Z ER EY T IH NG
COMMON	K AA M AH N
COMPARE	K AH M P EH R
COMPLAIN	K AH M P L EY N
COMPLETE	K AH M P L IY T
COMPLEXION	K AH M P L EH K SH AH N
COMPLICATE	K AA M P L AH K EY T
CONCEPT	K AA N S EH P T
CONFESS	K AH N F EH S
CONFESSIONS	K AH N F EH SH AH N Z
CONFUSED	K AH N F Y UW Z D
CONSIDER	K AH N S IH D ER
CONSTANTLY	K AA N S T AH N T L IY
CONSUMED	K AH N S UW M D
CONTENT	K AA N T EH N T
CONTENT	K AH N T EH N T
CONTROL	K AH N T R OW L
CONTROLS	K AH N T R OW L Z
CONVERSATION	K AA N V ER S EY SH AH N
COOL	K UW L
COPPER	K AA P ER
COPS	K AA P S
CORNER	K AO R N ER
COST	K AA S T
COST	K AO S T
COTTON	K AA T AH N
COTTON	K AO T AH N
COUCH	K AW CH
COULD	K UH D
COULDN'T	K UH D AH N T
COULDN'T	K UH D AH N
COUNTING	K AW N T IH NG
COUPLE	K AH P AH L
COURAGE	K ER IH JH
COURSE	K AO R S
COVERED	K AH V ER D
CRACKS	K R AE K S
CRAP	K R AE P
CRASH	K R AE SH
CRAWL	K R AO L
CRAZY	K R EY Z IY
CREAM	K R IY M
CREATE	K R IY EY T
CREDIT	K R EH D AH T
CREDIT	K R EH D IH T
CRIED	K R AY D
CRIES	K R AY Z
CRISP	K R IH S P
CROSS	K R AO S
CROWD	K R AW D
CRUEL	K R UW AH L
CRUEL	K R UW L
CRUISE	K R UW Z
CRUISING	K R UW Z IH NG
CRUMBLE	K R AH M B AH L
CRY	K R AY
CRYING	K R AY IH NG
CRYSTAL	K R IH S T AH L
CUP	K AH P
CUPID	K Y UW P IH D
CUPS	K AH P S
CUT	K AH T
CUTS	K AH T S
DA	D AA
DA	D IY EY
DAD	D AE D
DADDY	D AE D IY
DADDY'S	D AE D IY Z
DAILY	D EY L IY
DAKOTA	D AH K OW T AH
DAMN	D AE M
DAN	D AE N
DANCE	D AE N S
DANCIN'S	D AE N S AH N Z
DANCING	D AE N S IH NG
DANGEROUS	D EY N JH ER AH S
DARE	D EH R
DARK	D AA R K
DARKEST	D AA R K AH S T
DARKNESS	D AA R K N AH S
DARLING	D AA R L IH NG
DAUGHTERS	D AO T ER Z
DAVY	D EY V IY
DAWN'S	D AO N Z
DAY	D EY
DAYLIGHTS	D EY L AY T S
DAYS	D EY Z
DAZING	D EY Z IH NG
DAZZLING	D AE Z AH L IH NG
DAZZLING	D AE Z L IH NG
DE	D IY
DE	D EY
DE	D AH
DEAD	D EH D
DEAF	D EH F
DEAL	D IY L
DEALING	D IY L IH NG
DEALT	D EH L T
DEAR	D IH R
DECATUR	D IH K EY T ER
DECEIVING	D IH S IY V IH NG
DECIDE	D IH S AY D
DECIDED	D IH S AY D IH D
DEEP	D IY P
DEEPER	D IY P ER
DEFEAT	D IH F IY T
DEFENCE	D IH F EH N S
DEFEND	D IH F EH N D
DEFINE	D IH F AY N
DEGREE	D IH G R IY
DEGRESS	D IH G R EH S
DELILAH	D AH L AY L AH
DELILAH	D IH L AY L AH
DELIRIOUS	D IH L IH R IY AH S
DEMONS	D IY M AH N Z
DENIED	D IH N AY D
DENY	D IH N AY
DEPEND	D IH P EH N D
DESCENT	D IH S EH N T
DESCRIBE	D IH S K R AY B
DESCRIPTION	D IH S K R IH P SH AH N
DESERT	D EH Z ER T
DESERT	D IH Z ER T
DESERVE	D IH Z ER V
DESERVES	D IH Z ER V Z
DESIRE	D IH Z AY ER
DESTINY	D EH S T AH N IY
DESTROY	D IH S T R OY
DETROIT	D IH T R OY T
DETROIT	D IY T R OY T
DEVI	D AH V IY
DEVIL	D EH V AH L
DEVIL'S	D EH V AH L Z
DEVILS	D EH V AH L Z
DEVOTION	D IH V OW SH AH N
DI	D IY
DI	D AY
DIAMOND	D AY M AH N D
DIAMONDS	D AY M AH N D Z
DID	D IH D
DIDIN'T	D IH D IY AH N T
DIDN'T	D IH D AH N T
DIDN'T	D IH D N T
DIDN'T	D IH D AH N
DIDN'T	D IH N T
DIE	D AY
DIED	D AY D
DIFFER	D IH F ER
DIFFERENT	D IH F ER AH N T
DIFFERENT	D IH F R AH N T
DIGNITY	D IH G N AH T IY
DIME	D AY M
DIMES	D AY M Z
DIN	D IH N
DING	D IH NG
DIRECTION	D ER EH K SH AH N
DIRECTION	D IY R EH K SH IH N
DIRECTION	D AY R EH K SH IH N
DIRECTION	D IH R EH K SH IH N
DIRT	D ER T
DIRTY	D ER T IY
DISABILATIES	D IH S AH B AY L EY T IY Z
DISAPPEAR	D IH S AH P IH R
DISAPPEAR	D IH S AH P IY R
DISAPPEARING	D IH S AH P IH R IH NG
DISAPPEARING	D IH S AH P IY R IH NG
DISCOURAGED	D IH S K ER IH JH D
DISGUISE	D IH S G AY Z
DISPLAYED	D IH S P L EY D
DISTANCE	D IH S T AH N S
DIVE	D AY V
DIVINE	D IH V AY N
DIZZY	D IH Z IY
DO	D UW
DOCK	D AA K
DODGING	D AA JH IH NG
DOES	D AH Z
DOES	D IH Z
DOESN'T	D AH Z AH N T
DOESN'T	D AH Z AH N
DOG	D AO G
DOH	D OW
DOIN	D UW IH N
DOING	D UW IH NG
DOLE	D OW L
DOLLARS	D AA L ER Z
DOLLARS	D AO L ER Z
DOMESTICATE	D AH M EH S T AH K EY T
DON	D AA N
DON'T	D OW N T
DON'T	D OW N
DONE	D AH N
DONG	D AO NG
DONG	D AO NG G
DOOM	D UW M
DOOOOOWWN	D UW UW OW W N
DOOOOWN	D UW UW W N
DOOR	D AO R
DORE	D AO R
DORMEZ	D AO R M AH Z
DOT	D AA T
DOUBT	D AW T
DOUGIE	D UW G IY
DOW	D AW
DOWN	D AW N
DOWNTOWN	D AW N T AW N
DOZEN	D AH Z AH N
DRAG	D R AE G
DRAMATIC	D R AH M AE T IH K
DREAM	D R IY M
DREAMING	D R IY M IH NG
DREAMS	D R IY M Z
DRESS	D R EH S
DRESSES	D R EH S AH Z
DRESSES	D R EH S IH Z
DREW	D R UW
DRIFT	D R IH F T
DRINK	D R IH NG K
DRINKING	D R IH NG K IH NG
DRINKS	D R IH NG K S
DRIPPING	D R IH P IH NG
DRIVE	D R AY V
DRIVING	D R AY V IH NG
DROVE	D R OW V
DROWN	D R AW N
DROWNING	D R AW N IH NG
DROWNS	D R AW N Z
DRUG	D R AH G
DRUNK	D R AH NG K
DRY	D R AY
DRYWALL	D R AY W AA L
DUDE	D UW D
DUM	D AH M
DUMB	D AH M
DUST	D AH S T
DYING	D AY IH NG
E	IY
EACH	IY CH
EAGLE	IY G AH L
EAR	IY R
EAR	IH R
EARLY	ER L IY
EARNED	ER N D
EARTH	ER TH
EASE	IY Z
EASIER	IY Z IY ER
EASILY	IY Z AH L IY
EAST	IY S T
EASY	IY Z IY
ECONOMY	IH K AA N AH M IY
ECONOMY	IY K AA N AH M IY
EDEN	IY D AH N
EDGE	EH JH
EGO	IY G OW
EH	EH
EIGHT	EY T
EIGHTY	EY T IY
ELECTRIC	IH L EH K T R IH K
ELSE	EH L S
EMOTION	IH M OW SH AH N
EMOTION	IY M OW SH AH N
EMOTIONAL	IH M OW SH AH N AH L
EMOTIONAL	IY M OW SH AH N AH L
EMPTINESS	EH M P T IY N AH S
EMPTINESS	EH M T IY N AH S
EMPTY	EH M P T IY
EMPTY	EH M T IY
END	EH N D
ENDING	EH N D IH NG
ENDLESS	EH N D L AH S
ENDS	EH N D Z
ENEMY	EH N AH M IY
ENJOY	EH N JH OY
ENOUGH	IH N AH F
ENOUGH	IY N AH F
ENTITY	EH N T AH T IY
ENTITY	EH N T IH T IY
ENVY	EH N V IY
ESCAPE	IH S K EY P
ESTATE	EH S T EY T
EVAPORATE	IH V AE P ER EY T
EVEN	IY V IH N
EVENING	IY V N IH NG
EVER	EH V ER
EVERGREEN	EH V ER G R IY N
EVERY	EH V ER IY
EVERY	EH V R IY
EVERYBODY	EH V R IY B AA D IY
EVERYBODY'S	EH V R IY B AA D IY Z
EVERYONE	EH V R IY W AH N
EVERYTHING	EH V R IY TH IH NG
EVERYTHING'	EH V R IY TH IH NG
EVERYTHING'S	EH V R IY TH IH NG Z
EVERYWHERE	EH V R IY W EH R
EVERYWHERE	EH V R IY HH W EH R
EXCITED	IH K S AY T AH D
EXCITED	IH K S AY T IH D
EXCUSE	IH K S K Y UW S
EXCUSE	IH K S K Y UW Z
EXPENSE	IH K S P EH N S
EXPLORE	IH K S P L AO R
EXTRAORDINARY	EH K S T R AH AO R D AH N EH R IY
EXTRAORDINARY	IH K S T R AO R D AH N EH R IY
EY	IY IY
EYE	AY
EYEBALL	AY B AO L
EYELASHES	AY L AE SH IH Z
EYES	AY Z
FACE	F EY S
FACED	F EY S T
FACES	F EY S AH Z
FACES	F EY S IH Z
FACING	F EY S IH NG
FADE	F EY D
FADED	F EY D AH D
FADED	F EY D IH D
FAIL	F EY L
FAILED	F EY L D
FAIR	F EH R
FAIRY	F EH R IY
FAITH	F EY TH
FAKE	F EY K
FALL	F AO L
FALL	F AA L
FALLEN	F AA L AH N
FALLING	F AA L IH NG
FALLS	F AO L Z
FAME	F EY M
FAMILIAR	F AH M IH L Y ER
FAMILY	F AE M AH L IY
FAMILY	F AE M L IY
FAMOUS	F EY M AH S
FAN	F AE N
FANCY	F AE N S IY
FANTA	F AA N T AH
FANTASIES	F AE N T AH S IY Z
FANTASIES	F AE N AH S IY Z
FANTASTIC	F AE N T AE S T IH K
FANTASY	F AE N T AH S IY
FANTASY	F AE N AH S IY
FAR	F AA R
FARM	F AA R M
FARMER	F AA R M ER
FARMYOU	F AA R M AY UW
FASHION	F AE SH AH N
FAST	F AE S T
FATE	F EY T
FATHER'S	F AA DH ER Z
FAULT	F AO L T
FAVORITE	F EY V ER IH T
FAVORITE	F EY V R AH T
FE	F EY
FEAR	F IH R
FED	F EH D
FEEL	F IY L
FEELING	F IY L IH NG
FEELINGS	F IY L IH NG Z
FEELS	F IY L Z
FEET	F IY T
FELL	F EH L
FELLA	F EH L AH
FELT	F EH L T
FERRARI	F ER AA R IY
FEVER	F IY V ER
FEW	F Y UW
FIED	F AY D
FIELD	F IY L D
FIFTEEN	F IH F T IY N
FIFTY	F IH F T IY
FIGHT	F AY T
FIGHTING	F AY T IH NG
FIGURE	F IH G Y ER
FILL	F IH L
FILLED	F IH L D
FILLS	F IH L Z
FILM	F IH L M
FIND	F AY N D
FINDING	F AY N D IH NG
FINE	F AY N
FINGER	F IH NG G ER
FINGERPRINTS	F IH NG G ER P R IH N T S
FINS	F IH N Z
FIRE	F AY ER
FIRE	F AY R
FIREFLIES	F AY ER F L AY Z
FIREFLY	F AY ER F L AY
FIREPLACE	F AY ER P L EY S
FIRST	F ER S T
FISH	F IH SH
FIST	F IH S T
FISTFUL	F IH S T F AH L
FIVE	F AY V
FIX	F IH K S
FLAG	F L AE G
FLAILING	F L EY L IH NG
FLAME	F L EY M
FLAMES	F L EY M Z
FLASHING	F L AE SH IH NG
FLAWLESS	F L AO L AH S
FLIES	F L AY Z
FLIGHT	F L AY T
FLIPPING	F L IH P IH NG
FLOATING	F L OW T IH NG
FLOOR	F L AO R
FLOWED	F L OW D
FLOWERED	F L AW ER D
FLOWERS	F L AW ER Z
FLY	F L AY
FOGGED	F AA G D
FOLLOW	F AA L OW
FOLLOWED	F AA L OW D
FOOL	F UW L
FOOLISH	F UW L IH SH
FOOLS	F UW L Z
FOR	F AO R
FOR	F ER
FOR	F R ER
FORCE	F AO R S
FOREHEAD	F AO R HH EH D
FORESIGHT	F AO R S AY T
FOREVER	F ER EH V ER
FORGET	F ER G EH T
FORGET	F AO R G EH T
FORGETTING	F ER G EH T IH NG
FORGETTING	F AO R G EH T IH NG
FORGOTTEN	F ER G AA T AH N
FORGOTTEN	F AO R G AA T AH N
FORTUNE	F AO R CH AH N
FORTUNE	F AO R CH UW N
FORTY	F AO R T IY
FOUND	F AW N D
FOUNTAIN	F AW N T AH N
FOUR	F AO R
FREE	F R IY
FREEDOM	F R IY D AH M
FREEWHEELING	F R IY W IY L IH NG
FREEWHEELING	F R IY HH W IY L IH NG
FREEZE	F R IY Z
FREQUENTLY	F R IY K W AH N T L IY
FREQUENTLY	F R IY K W EH N T L IY
FRERE	F R EH R
FRERE	F R IH R
FRICKING	F R IH K IH NG
FRIEND	F R EH N D
FRIENDS	F R EH N D Z
FROM	F R AH M
FRONT	F R AH N T
FROSTY	F R AO S T IY
FROWNS	F R AW N Z
FROZEN	F R OW Z AH N
FRUSTRATION	F R AH S T R EY SH AH N
FUCKED	F AH K T
FUCKING	F AH K IH NG
FUEL	F Y UW AH L
FUEL	F Y UW L
FULFILLED	F UH L F IH L D
FULL	F UH L
FUN	F AH N
FUNNY	F AH N IY
FUTURE	F Y UW CH ER
FUZZY	F AH Z IY
G	JH IY
GADGETS	G AE JH AH T S
GAIN	G EY N
GALLANTLY	G AE L AH N T L IY
GALORE	G AH L AO R
GAME	G EY M
GAMES	G EY M Z
GARDEN	G AA R D AH N
GAS	G AE S
GAVE	G EY V
GAY	G EY
GEESE	G IY S
GENERATION	JH EH N ER EY SH AH N
GEO	JH IY OW
GEORGIA	JH AO R JH AH
GET	G EH T
GET	G IH T
GETAWAY	G EH T AH W EY
GETS	G EH T S
GETS	G IH T S
GETTING	G EH T IH NG
GETTING	G IH T IH NG
GIDDY	G IH D IY
GIFT	G IH F T
GIMME	G IH M IY
GIN	JH IH N
GINGER	JH IH N JH ER
GIRL	G ER L
GIRLS	G ER L Z
GIVE	G IH V
GIVEN	G IH V AH N
GIVEN	G IH V IH N
GIVES	G IH V Z
GIVING	G IH V IH NG
GIZMOS	G IH Z M OW Z
GLADLY	G L AE D L IY
GLADNESS	G L AE D N AH S
GLARE	G L EH R
GLASS	G L AE S
GLEAMING	G L IY M IH NG
GLIDING	G L AY D IH NG
GLITTERS	G L IH T ER Z
GLORY	G L AO R IY
GLOW	G L OW
GO	G OW
GOAT	G OW T
GOD	G AA D
GOD'S	G AA D Z
GODFORSAKEN	G AA D F AO R S EY K AH N
GOES	G OW Z
GOIN'	G OW AH N
GOING	G OW IH NG
GOING	G OW IH N
GOLD	G OW L D
GOLDEN	G OW L D AH N
GONE	G AO N
GONNA	G AA N AH
GOOD	G UH D
GOOD	G IH D
GOODBYE	G UH D B AY
GOODNIGHT	G UH D N AY T
GORILLA	G ER IH L AH
GORILLAS	G ER IH L AH Z
GOT	G AA T
GOTTA	G AA T AH
GRAB	G R AE B
GRABBED	G R AE B D
GRACES	G R EY S IH Z
GRANT	G R AE N T
GRANTING	G R AE N T IH NG
GRANTING	G R AE N IH NG
GRASS	G R AE S
GRAY	G R EY
GREAT	G R EY T
GREATER	G R EY T ER
GREATEST	G R EY T AH S T
GREEN	G R IY N
GREETS	G R IY T S
GRENADE	G R AH N EY D
GRIP	G R IH P
GROUND	G R AW N D
GROW	G R OW
GUESS	G EH S
GUIDE	G AY D
GUIDED	G AY D AH D
GUIDED	G AY D IH D
GUITAR	G IH T AA R
GUITAR'S	G IH T AA R Z
GUY	G AY
H	EY CH
HAAA	HH AA AH
HAD	HH AE D
HAILED	HH EY L D
HAIR	HH EH R
HALFWAY	HH AE F W EY
HAND	HH AE N D
HANDFUL	HH AE N D F UH L
HANDLE	HH AE N D AH L
HANDS	HH AE N D Z
HANDS	HH AE N Z
HANG	HH AE NG
HANGING	HH AE NG IH NG
HANGING	HH AE NG G IH NG
HAPPEN	HH AE P AH N
HAPPENING	HH AE P AH N IH NG
HAPPENING	HH AE P N IH NG
HAPPENS	HH AE P AH N Z
HAPPY	HH AE P IY
HARD	HH AA R D
HARM	HH AA R M
HARMONY	HH AA R M AH N IY
HAS	HH AE Z
HAS	HH AH Z
HASN'T	HH AE Z AH N T
HAT	HH AE T
HATE	HH EY T
HATES	HH EY T S
HAUNTS	HH AO N T S
HAVE	HH AE V
HAVEN'T	HH AE V AH N T
HAVEN'T	HH AE V AH N
HAVING	HH AE V IH NG
HE	HH IY
HE'D	HH IY D
HE'LL	HH IY L
HE'S	HH IY Z
HEAD	HH EH D
HEADED	HH EH D AH D
HEADED	HH EH D IH D
HEADLINES	HH EH D L AY N Z
HEALTHY	HH EH L TH IY
HEAR	HH IY R
HEARD	HH ER D
HEARS	HH IY R Z
HEART	HH AA R T
HEARTACHE	HH AA R T EY K
HEARTBEAT	HH AA R T B IY T
HEARTFINISH	HH AA R T F IH N IH SH
HEARTS	HH AA R T S
HEAT	HH IY T
HEAVEN	HH EH V AH N
HEAVENLY	HH EH V AH N L IY
HEAVENS	HH EH V AH N Z
HEAVY	HH EH V IY
HEEEEEY	HH IY IY IY
HEEEY	HH IY IY
HEELS	HH IY L Z
HEINA	HH IY N AH
HELD	HH EH L D
HELL	HH EH L
HELP	HH EH L P
HELPED	HH EH L P T
HER	HH ER
HERE	HH IY R
HERE'S	HH IH R Z
HERO	HH IH R OW
HERO	HH IY R OW
HERSELF	HH ER S EH L F
HESITATE	HH EH Z AH T EY T
HEY	HH EY
HIDE	HH AY D
HIDES	HH AY D Z
HIGH	HH AY
HIGHER	HH AY ER
HILL	HH IH L
HILLS	HH IH L Z
HIM	HH IH M
HIM	IH M
HINT	HH IH N T
HIS	HH IH Z
HISTORY	HH IH S T ER IY
HISTORY	HH IH S T R IY
HIT	HH IH T
HITTING	HH IH T IH NG
HM	HH AH M
HMM	HH AH M
HMMM	EY CH EH M EH M
HMMMM	EY CH EH M EH M EH M
HO	HH OW
HOLD	HH OW L D
HOLDING	HH OW L D IH NG
HOLDS	HH OW L D Z
HOLE	HH OW L
HOLLOW	HH AA L OW
HOLY	HH OW L IY
HOME	HH OW M
HOMEBOY	HH OW M B OY
HONESTLY	AA N AH S T L IY
HONESTLY	AA N AH S L IY
HONEY	HH AH N IY
HOO	HH UW
HOOK	HH UH K
HOP	HH AA P
HOPE	HH OW P
HOPPED	HH AA P T
HORIZONS	HH ER AY Z AH N Z
HORSE	HH AO R S
HOT	HH AA T
HOTTEST	HH AA T AH S T
HOUR	AW ER
HOUR	AW R
HOURS	AW ER Z
HOURS	AW R Z
HOUSE	HH AW S
HOUSTON	HH Y UW S T AH N
HOW	HH AW
HUFFING	HH AH F IH NG
HUG	HH AH G
HUH	HH AH
HUMAN	HH Y UW M AH N
HUMAN	Y UW M AH N
HUMANS	HH Y UW M AH N Z
HUMANS	Y UW M AH N Z
HUMBLE	HH AH M B AH L
HUNDRED	HH AH N D R AH D
HUNDRED	HH AH N D R IH D
HUNDRED	HH AH N ER D
HUNDRED	HH AH N D ER D
HUNG	HH AH NG
HURRICANE	HH ER AH K EY N
HURRICANE	HH AH R AH K EY N Z
HURT	HH ER T
HURTS	HH ER T S
HUSBAND	HH AH Z B AH N D
HUSH	HH AH SH
HYPNOTIZED	HH IH P N AH T AY Z D
I	AY
I'D	AY D
I'LL	AY L
I'M	AY M
I'M	AH M
I'MA	IH M AH
I'VE	AY V
ICE	AY S
IDIOT	IH D IY AH T
IF	IH F
IMAGINE	IH M AE JH AH N
IMPRESSION	IH M P R EH SH AH N
IN	IH N
INCHES	IH N CH AH Z
INCHES	IH N CH IH Z
INCREDIBLE	IH N K R EH D AH B AH L
INDEFINITELY	IH N D EH F AH N AH T L IY
INDESCRIBABLE	IH N D IH S K R AY B AH B AH L
INFINITY	IH N F IH N IH T IY
INNOCENCE	IH N AH S AH N S
INNOCENT	IH N AH S AH N T
INSANE	IH N S EY N
INSANITY	IH N S AE N AH T IY
INSANITY	IH N S AE N IH T IY
INSECURE	IH N S AH K Y ER
INSIDE	IH N S AY D
INSIDES	IH N S AY D Z
INSTEAD	IH N S T EH D
INTEGRITY	IH N T EH G R AH T IY
INTERVENTION	IH N T ER V EH N SH AH N
INTO	IH N T UW
INTO	IH N T AH
INVITED	IH N V AY T AH D
INVITED	IH N V AY T IH D
IS	IH Z
ISN'T	IH Z AH N T
ISN'T	IH Z AH N
IT	IH T
IT'D	IH T AH D
IT'LL	IH T AH L
IT'LL	IH T L
IT'S	IH T S
ITEM	AY T AH M
ITS	IH T S
IVORY	AY V ER IY
IVORY	AY V R IY
JACK	JH AE K
JACQUES	ZH AA K
JACQUES	JH AE K
JADED	JH EY D AH D
JADED	JH EY D IH D
JAIL	JH EY L
JAMAICA	JH AH M EY K AH
JAR	JH AA R
JAY	JH EY
JEANS	JH IY N Z
JENNY	JH EH N IY
JESUS	JH IY Z AH S
JINGLE	JH IH NG G AH L
JINGLING	JH IH NG G AH L IH NG
JOB	JH AA B
JOB	JH OW B
JOHN	JH AA N
JOKE	JH OW K
JONES	JH OW N Z
JOURNEY	JH ER N IY
JOURNEYS	JH ER N IY Z
JOY	JH OY
JUDGING	JH AH JH IH NG
JUH	JH UW
JUICE	JH UW S
JUMP	JH AH M P
JUMPING	JH AH M P IH NG
JUNGLE	JH AH NG G AH L
JUST	JH AH S T
JUST	JH IH S T
KC	K EY K
KEEP	K IY P
KEEPING	K IY P IH NG
KEEPS	K IY P S
KENNEDY	K EH N AH D IY
KEPT	K EH P T
KEPT	K AE P T
KETTLES	K EH T AH L Z
KEY	K IY
KICK	K IH K
KICKED	K IH K T
KICKER	K IH K ER
KICKING	K IH K IH NG
KID	K IH D
KIDS	K IH D Z
KILL	K IH L
KILLER	K IH L ER
KILLING	K IH L IH NG
KILLS	K IH L Z
KIND	K AY N D
KINDA	K IH N D AH
KING	K IH NG
KISS	K IH S
KIT	K IH T
KITCHEN	K IH CH AH N
KITTENS	K IH T AH N Z
KNEES	N IY Z
KNEW	N UW
KNEW	N Y UW
KNIFE	N AY F
KNIVES	N AY V Z
KNOCK	N AA K
KNOCKING	N AA K IH NG
KNOW	N OW
KNOWN	N OW N
KNOWS	N OW Z
KRYPTONITE	K R IH P T OW N AY T
L	EH L
LA	L AA
LACE	L EY S
LACK	L AE K
LADY	L EY D IY
LAGOON	L AH G UW N
LAID	L EY D
LAKES	L EY K S
LAND	L AE N D
LANDSLIDE	L AE N D S L AY D
LANDSLIDE	L AE N S L AY D
LANE	L EY N
LAST	L AE S T
LATE	L EY T
LATELY	L EY T L IY
LATER	L EY T ER
LATER'S	L EY T ER Z
LAUGH	L AE F
LAUGHED	L AE F T
LAUGHING	L AE F IH NG
LAUGHTER	L AE F T ER
LAWYER	L AO Y ER
LAWYER	L OY ER
LAY	L EY
LEAD	L EH D
LEAD	L IY D
LEARN	L ER N
LEARNED	L ER N D
LEARNED	L ER N IH D
LEARNING	L ER N IH NG
LEAST	L IY S T
LEAVE	L IY V
LEAVES	L IY V Z
LEAVING	L IY V IH NG
LEBANESE	L EH B AH N IY Z
LEFT	L EH F T
LEG	L EH G
LEGS	L EH G Z
LENGTHS	L EH NG K TH S
LENGTHS	L EH NG TH S
LES	L EH
LESBIAN	L EH Z B IY AH N
LESS	L EH S
LESSONS	L EH S AH N Z
LET	L EH T
LET'S	L EH T S
LETTER	L EH T ER
LETTERS	L EH T ER Z
LETTING	L EH T IH NG
LIAR	L AY ER
LIBERATE	L IH B ER EY T
LIE	L AY
LIED	L AY D
LIES	L AY Z
LIFE	L AY F
LIFE'S	L AY F S
LIFT	L IH F T
LIGHT	L AY T
LIGHTS	L AY T S
LIKE	L AY K
LIKED	L AY K T
LIKING	L AY K IH NG
LINCOLN	L IH NG K AH N
LINE	L AY N
LINES	L AY N Z
LINGER	L IH NG G ER
LINGER	L IH NG ER
LIP	L IH P
LIPS	L IH P S
LIQUOR	L IH K ER
LIST	L IH S T
LISTEN	L IH S AH N
LISTENER	L IH S AH N ER
LISTENER	L IH S N ER
LITTLE	L IH T AH L
LIVE	L AY V
LIVE	L IH V
LIVER	L IH V ER
LIVES	L IH V Z
LIVES	L AY V Z
LIVING	L IH V IH NG
LOCAL	L OW K AH L
LOCK	L AA K
LOGIC	L AA JH IH K
LOGICAL	L AA JH IH K AH L
LOIS	L OW AH S
LONELINESS	L OW N L IY N AH S
LONELY	L OW N L IY
LONG	L AO NG
LONGER	L AO NG G ER
LONGING	L AO NG IH NG
LOOK	L UH K
LOOKED	L UH K T
LOOKING	L UH K IH NG
LOOKS	L UH K S
LOOOOOOOOVE	L UW UW UW UW V
LOOOOOVE	L UW UW OW V
LOOOORD	L UW AH R D
LOOOVE	L UW OW V
LOOSE	L UW S
LORD	L AO R D
LOSE	L UW Z
LOSING	L UW Z IH NG
LOST	L AO S T
LOT	L AA T
LOT	L AO T
LOUISE	L UW IY Z
LOUNGING	L AW N JH IH NG
LOVE	L AH V
LOVE'S	L AH V Z
LOVED	L AH V D
LOVER	L AH V ER
LOVERBOY	L AH V ER B OY
LOVES	L AH V Z
LOVING	L AH V IH NG
LOW	L OW
LOWER	L OW ER
LUCK	L AH K
LUCKY	L AH K IY
LYING	L AY IH NG
LYRICAL	L IH R IH K AH L
M	EH M
MA	M AA
MA'	M AA
MACHINE	M AH SH IY N
MAD	M AE D
MADE	M EY D
MADMAN	M AE D M AE N
MAGAZINES	M AE G AH Z IY N Z
MAGIC	M AE JH IH K
MAGICAL	M AE JH IH K AH L
MAKE	M EY K
MAKER	M EY K ER
MAKES	M EY K S
MAKEUP	M EY K AH P
MAKING	M EY K IH NG
MALIBU	M AE L AH B UW
MAMA	M AA M AH
MAMA'S	M AA M AH Z
MAN	M AE N
MAN'S	M AE N Z
MANAGER	M AE N AH JH ER
MANAGER	M AE N IH JH ER
MANY	M EH N IY
MAP	M AE P
MARKED	M AA R K T
MARRY	M EH R IY
MARSHALL	M AA R SH AH L
MATCH	M AE CH
MATCHES	M AE CH AH Z
MATCHES	M AE CH IH Z
MATH	M AE TH
MATINES	M AH T IH N EH
MATTER	M AE T ER
MATTERS	M AE T ER Z
MAY	M EY
MAYBE	M EY B IY
ME	M IY
MEAN	M IY N
MEANS	M IY N Z
MEANT	M EH N T
MEASURE	M EH ZH ER
MEDIA	M IY D IY AH
MEDICATION	M EH D AH K EY SH AH N
MEEEE	M IY IY IY
MEET	M IY T
MEETING	M IY T IH NG
MEETS	M IY T S
MELODY	M EH L AH D IY
MELT	M EH L T
MELTED	M EH L T AH D
MELTED	M EH L T IH D
MELTING	M EH L T IH NG
MEMORIES	M EH M ER IY Z
MEMORY	M EH M ER IY
MEN	M EH N
MEND	M EH N D
MESS	M EH S
MESSAGE	M EH S AH JH
MESSAGE	M EH S IH JH
MESSAGES	M EH S AH JH AH Z
MESSAGES	M EH S IH JH IH Z
MET	M EH T
MI	M IY
MICROPHONE	M AY K R AH F OW N
MIDDLE	M IH D AH L
MIDNIGHTS	M IH D N AY T S
MIGHT	M AY T
MIGHTY	M AY T IY
MILES	M AY L Z
MILES	M AY AH L Z
MILKY	M IH L K IY
MILLION	M IH L Y AH N
MIND	M AY N D
MINDS	M AY N D Z
MINE	M AY N
MINGLING	M IH NG G AH L IH NG
MINGLING	M IH NG G L IH NG
MINNESOTA	M IH N IH S OW T AH
MINUITES	M AH N UW T S
MINUTE	M IH N AH T
MINUTE	M AY N UW T
MINUTE	M AY N Y UW T
MINUTES	M IH N AH T S
MIRACLE	M IH R AH K AH L
MIRROR	M IH R ER
MIRRORS	M IH R ER Z
MISS	M IH S
MISSED	M IH S T
MISTAKE	M IH S T EY K
MISTAKES	M IH S T EY K S
MISTLETOE	M IH S AH L T OW
MITTENS	M IH T AH N Z
MIX	M IH K S
MM	EH M
MMH	EH M EH M
MMM	EH M EH M
MMMM	EH M EH M EH M
MMMMMM	EH M EH M EH M EH M EH M
MMMMMMH	EH M EH M EH M EH M EH M EH M
MMMMMMM	EH M EH M EH M EH M EH M EH M
MOCKING	M AA K IH NG
MOLD	M OW L D
MOMENT	M OW M AH N T
MOMENTS	M OW M AH N T S
MOMMA	M AA M AH
MOMMA'S	M AA M AH Z
MONEY	M AH N IY
MONTH	M AH N TH
MOOD	M UW D
MOON	M UW N
MOONLIGHT	M UW N L AY T
MOONLIT	M UW N L IH T
MOOOOD	M UW UW D
MOOOORE	M UW AH R
MORE	M AO R
MORNING	M AO R N IH NG
MORNINGS	M AO R N IH NG Z
MORPHINE	M AO R F IY N
MOSS	M AO S
MOST	M OW S T
MOST	M OW S
MOTHER'S	M AH DH ER Z
MOTHERLOVER	M AH DH ER L AH V ER
MOUNTAIN	M AW N T AH N
MOVE	M UW V
MOVED	M UW V D
MOVIE	M UW V IY
MOVING	M UW V IH NG
MTV	EH M T IY V IY
MUCH	M AH CH
MUSIC	M Y UW Z IH K
MUST	M AH S T
MY	M AY
MYSELF	M AY S EH L F
MYSTERIES	M IH S T ER IY Z
MYSTERY	M IH S T ER IY
N	EH N
N'	EH N
NA	N AA
NAH	N AA
NAME	N EY M
NAMED	N EY M D
NAMES	N EY M Z
NASTY	N AE S T IY
NATURE	N EY CH ER
NAVY	N EY V IY
NEAT	N IY T
NECK	N EH K
NEED	N IY D
NEEDED	N IY D AH D
NEEDED	N IY D IH D
NEEDS	N IY D Z
NEIGHBORS	N EY B ER Z
NEITHER	N IY DH ER
NEITHER	N AY DH ER
NERVE	N ER V
NEVER	N EH V ER
NEW	N UW
NEW	N Y UW
NEWS	N UW Z
NEWS	N Y UW Z
NEXT	N EH K S T
NEXT	N EH K S
NIBBLE	N IH B AH L
NICE	N AY S
NICE	N IY S
NICK	N IH K
NIGHT	N AY T
NIGHTLY	N AY T L IY
NIGHTS	N AY T S
NINE	N AY N
NINETY	N AY N T IY
NINTENDO	N IH N T EH N D OW
NO	N OW
NOBODY	N OW B AA D IY
NOBODY	N OW B AH D IY
NOBODY'S	N OW B AA D IY Z
NOBODY'S	N OW B AH D IY Z
NOISES	N OY Z IH Z
NONE	N AH N
NOODLES	N UW D AH L Z
NOOOO	N UW UW
NOOOOOO	N UW UW UW
NOR	N AO R
NORTH	N AO R TH
NOSE	N OW Z
NOT	N AA T
NOTHIN'S	N AA TH IH N Z
NOTHING	N AH TH IH NG
NOTHING'S	N AH TH IH NG Z
NOTICE	N OW T AH S
NOTICE	N OW T IH S
NOTION	N OW SH AH N
NOVELIST	N AA V AH L AH S T
NOW	N AW
NOW'S	N AW Z
NUMB	N AH M
NUMBED	N AH M D
NUMBER	N AH M B ER
O	OW
O'CLOCK	AH K L AA K
O'ER	OW ER
OASIS	OW EY S IH S
OATH	OW TH
OBSESSION	AH B S EH SH AH N
OBVIOUSLY	AA B V IY AH S L IY
OCCUPIED	AA K Y AH P AY D
OCCUPY	AA K Y AH P AY
OCEAN	OW SH AH N
OF	AH V
OFF	AO F
OFTEN	AO F T AH N
OFTEN	AO F AH N
OH	OW
OHH	OW
OKAY	OW K EY
OLD	OW L D
OLDER	OW L D ER
ON	AA N
ON	AO N
ONCE	W AH N S
ONE	W AH N
ONE	HH W AH N
ONE'S	W AH N Z
ONES	W AH N Z
ONLY	OW N L IY
OO	UW
OOH	UW
OOO	UW OW
OOOH	UW
OOOOH	UW UW
OOOOOH	UW UW OW
OOOOOOOH	UW UW UW OW
OOOOOOOOH	UW UW UW UW
OPEN	OW P AH N
OPENED	OW P AH N D
OPTIMIST	AA P T AH M IH S T
OR	AO R
OR	ER
ORIENT	AO R IY EH N T
OT	AO T
OT	OW T IY
OTHER	AH DH ER
OTHER'S	AH DH ER Z
OUGHT	AO T
OUGHTA	AO T AH
OUR	AW ER
OUR	AW R
OUR	AA R
OURS	AW ER Z
OURS	AA R Z
OURS	AW R Z
OUT	AW T
OUTCAST	AW T K AE S T
OUTSIDE	AW T S AY D
OVER	OW V ER
OVERSEAS	OW V ER S IY Z
OVERTHROWN	OW V ER TH R OW N
OWN	OW N
PA	P AA
PACKAGES	P AE K AH JH AH Z
PACKAGES	P AE K IH JH IH Z
PACKED	P AE K T
PAGE	P EY JH
PAID	P EY D
PAIN	P EY N
PAINT	P EY N T
PALE	P EY L
PANE	P EY N
PANTS	P AE N T S
PAPA	P AA P AH
PAPA'S	P AA P AA Z
PAPER	P EY P ER
PAPERS	P EY P ER Z
PARADE	P ER EY D
PARADISE	P EH R AH D AY S
PARIS	P EH R IH S
PARIS	P AE R IH S
PARK	P AA R K
PART	P AA R T
PARTY	P AA R T IY
PASS	P AE S
PASSING	P AE S IH NG
PASSION	P AE SH AH N
PAST	P AE S T
PATCHES	P AE CH AH Z
PATCHES	P AE CH IH Z
PATHWAY	P AE TH W EY
PATIENCE	P EY SH AH N S
PATIENT	P EY SH AH N T
PATRON	P EY T R AH N
PATTERNS	P AE T ER N Z
PAUL	P AO L
PAY	P EY
PEAT	P IY T
PENNIES	P EH N IY Z
PEOPLE	P IY P AH L
PERCUSSION	P ER K AH SH AH N
PERFECT	P ER F EH K T
PERFECT	P ER F IH K T
PERFUME	P ER F Y UW M
PERILOUS	P EH R IH L EH AO AO L EH S
PHARCYDE	F AA R S AY D
PHONE	F OW N
PHRASE	F R EY Z
PHYSICAL	F IH Z IH K AH L
PIANO	P IY AE N OW
PIANO	P IY AE N AH
PICK	P IH K
PICKING	P IH K IH NG
PICTURE	P IH K CH ER
PIECE	P IY S
PIECES	P IY S AH Z
PIECES	P IY S IH Z
PIER	P IH R
PILL	P IH L
PILLS	P IH L Z
PIMPING	P IH M P IH NG
PIN	P IH N
PISSED	P IH S T
PITCH	P IH CH
PITY	P IH T IY
PLA	P L AA
PLACE	P L EY S
PLACES	P L EY S AH Z
PLACES	P L EY S IH Z
PLAIN	P L EY N
PLAINS	P L EY N Z
PLAN	P L AE N
PLANE	P L EY N
PLANES	P L EY N Z
PLANS	P L AE N Z
PLANTS	P L AE N T S
PLASTIC	P L AE S T IH K
PLATTER	P L AE T ER
PLAY	P L EY
PLAYED	P L EY D
PLAYGROUND	P L EY G R AW N D
PLAYGROUND	P L EY G R AW N
PLAYING	P L EY IH NG
PLEASE	P L IY Z
PLEASURE	P L EH ZH ER
PLENTY	P L EH N T IY
PLENTY	P L EH N IY
PLUS	P L AH S
POCKET	P AA K AH T
POINT	P OY N T
POISON	P OY Z AH N
POLE	P OW L
POLITELY	P AH L AY T L IY
POLITICS	P AA L AH T IH K S
PONIES	P OW N IY Z
POP	P AA P
POPE	P OW P
POPPING	P AA P IH NG
POPS	P AA P S
POSE	P OW Z
POSSESS	P AH Z EH S
POSSIBLE	P AA S AH B AH L
POTIONS	P OW SH AH N Z
POUND	P AW N D
POUR	P AO R
POURING	P AO R IH NG
POWDER	P AW D ER
POWER	P AW ER
PRACTICAL	P R AE K T IH K AH L
PRACTICE	P R AE K T IH S
PRACTICING	P R AE K T IH S IH NG
PRANCING	P R AE N S IH NG
PRAY	P R EY
PRAYERS	P R EH R Z
PRAYERS	P R EY ER Z
PRAYING	P R EY IH NG
PRECIOUS	P R EH SH AH S
PRECIPITATION	P R IH S IH P IH T EY SH AH N
PREPARED	P R IY P EH R D
PRESENTS	P R EH Z AH N T S
PRESENTS	P R IY Z EH N T S
PRETEND	P R IY T EH N D
PRETENDING	P R IY T EH N D IH NG
PRETTY	P R IH T IY
PRIDE	P R AY D
PRINCESS	P R IH N S EH S
PRISON	P R IH Z AH N
PRISONER	P R IH Z AH N ER
PRISONER	P R IH Z N ER
PRIVATE	P R AY V AH T
PRIZE	P R AY Z
PROBABLY	P R AA B AH B L IY
PROCLAIM	P R OW K L EY M
PROJECTS	P R AA JH EH K T S
PROMISE	P R AA M AH S
PROMISED	P R AA M AH S T
PROMISES	P R AA M AH S AH Z
PROOF	P R UW F
PROP	P R AA P
PROPHETS	P R AA F AH T S
PROTECTION	P R AH T EH K SH AH N
PROUD	P R AW D
PROUDLY	P R AW D L IY
PROVE	P R UW V
PRUDENCE	P R UW D AH N S
PULL	P UH L
PURSUE	P ER S UW
PUSH	P UH SH
PUSHING	P UH SH IH NG
PUT	P UH T
PUZZLE	P AH Z AH L
QUADRILLION	K W AA D R IH L Y AH N
QUARTER	K W AO R T ER
QUEEN	K W IY N
QUESTION	K W EH S CH AH N
QUESTION	K W EH SH AH N
QUESTIONS	K W EH S CH AH N Z
QUICK	K W IH K
QUIET	K W AY AH T
QUINTILLION	K W IH N T IH L Y AH N
QUIT	K W IH T
QUITE	K W AY T
RA	R AA
RAAAA	R AA AH
RACE	R EY S
RADIO	R EY D IY OW
RAIN	R EY N
RAINBOW	R EY N B OW
RAINDROPS	R EY N D R AA P S
RAINING	R EY N IH NG
RAINY	R EY N IY
RAISE	R EY Z
RAISED	R EY Z D
RAMPARTS	R AE M P AA R T S
RAN	R AE N
RANG	R AE NG
RAPE	R EY P
RAPING	R EY P IH NG
RAPIST	R EY P IH S T
RATHER	R AE DH ER
RATHER	R AH DH ER
RATIONAL	R AE SH AH N AH L
RATIONAL	R AE SH N AH L
REACH	R IY CH
REACHING	R IY CH IH NG
READ	R EH D
READ	R IY D
READING	R IY D IH NG
READING	R EH D IH NG
READY	R EH D IY
REAL	R IY L
REALIZE	R IY AH L AY Z
REALLY	R IH L IY
REALLY	R IY L IY
REASON	R IY Z AH N
REASONS	R IY Z AH N Z
RECALL	R IY K AO L
RECALL	R IH K AO L
RECKON	R EH K AH N
RECONSIDER	R IY K AH N S IH D ER
RECORD	R AH K AO R D
RECORD	R EH K ER D
RECORD	R IH K AO R D
RECORDS	R AH K AO R D Z
RECORDS	R EH K ER D Z
RECORDS	R IH K AO R D Z
RECOVER	R IH K AH V ER
RED	R EH D
REFLECTION	R AH F L EH K SH AH N
REFLECTION	R IH F L EH K SH AH N
REFUSE	R AH F Y UW Z
REFUSE	R EH F Y UW Z
REFUSE	R IH F Y UW Z
REGRET	R AH G R EH T
REGRET	R IH G R EH T
REGULAR	R EH G Y AH L ER
REGULAR	R EY G Y AH L ER
REINDEERS	R IY IH N D IH ER Z
REJOICE	R IH JH OY S
RELATIONSHIP	R IY L EY SH AH N SH IH P
RELENTLESSLY	R IH L EH N T L AH S L IY
RELIEF	R IH L IY F
RELIEF	R IY L IY F
RELIGION	R IH L IH JH AH N
RELIGION	R IY L IH JH AH N
RELY	R IH L AY
RELY	R IY L AY
REMAIN	R IH M EY N
REMAIN	R IY M EY N
REMAINS	R IH M EY N Z
REMAINS	R IY M EY N Z
REMEDY	R EH M AH D IY
REMEMBER	R IH M EH M B ER
REMEMBER	R IY M EH M B ER
REMIND	R IY M AY N D
REPEAT	R IH P IY T
REPEAT	R IY P IY T
REPRIMAND	R EH P R AH M AE N D
REPUTATION	R EH P Y AH T EY SH AH N
REQUIRED	R IY K W AY ER D
REQUIRED	R IY K W AY R D
RESCUED	R EH S K Y UW D
RESIST	R IH Z IH S T
RESIST	R IY Z IH S T
RESPECT	R IH S P EH K T
RESPECT	R IY S P EH K T
RESTING	R EH S T IH NG
RESTRAINT	R IH S T R EY N T
RESTRAINT	R IY S T R EY N T
RESUSCITATES	R AH S AH S AH T EY T S
RETURN	R IH T ER N
RETURN	R IY T ER N
REVEALS	R IH V IY L Z
REVEALS	R IY V IY L Z
REVENGE	R IY V EH N JH
RHYME	R AY M
RHYMES	R AY M Z
RHYTHM	R IH DH AH M
RICH	R IH CH
RICHER	R IH CH ER
RICHES	R IH CH AH Z
RICHES	R IH CH IH Z
RID	R IH D
RIDE	R AY D
RIGHT	R AY T
RING	R IH NG
RINGING	R IH NG IH NG
RINGS	R IH NG Z
RIP	R IH P
RIPPED	R IH P T
RISE	R AY Z
RISING	R AY Z IH NG
RIVER	R IH V ER
ROAD	R OW D
ROADS	R OW D Z
ROAM	R OW M
ROCK	R AA K
ROCKET'S	R AA K AH T S
ROCKING	R AA K IH NG
ROCKS	R AA K S
ROGAINE	R OW G EY N
ROLL	R OW L
ROLLING	R OW L IH NG
ROME	R OW M
ROOF	R UW F
ROOF	R UH F
ROOM	R UW M
ROOM'S	R UW M Z
ROOTS	R UW T S
ROSES	R OW Z IH Z
ROUND	R AW N D
ROUTINE	R UW T IY N
ROVER	R OW V ER
RUBBLE	R AH B AH L
RUDE	R UW D
RUIN	R UW AH N
RUIN	R UW IH N
RUINED	R UW AH N D
RUINED	R UW IH N D
RUINING	R UW IH N IH NG
RULE	R UW L
RULES	R UW L Z
RUN	R AH N
RUNAWAY	R AH N AH W EY
RUNNING	R AH N IH NG
RUSH	R AH SH
RUSTY	R AH S T IY
SA	S AA
SACRIFICES	S AE K R AH F AY S IH Z
SAD	S AE D
SADNESS	S AE D N AH S
SAFE	S EY F
SAID	S EH D
SAIL	S EY L
SAINT	S EY N T
SAINTS	S EY N T S
SALE	S EY L
SALUTE	S AH L UW T
SAME	S EY M
SANCHITO	S AE NG K AH T OW
SANCHO	S AA N K OW
SANCHO'S	S AA N K OW Z
SAND	S AE N D
SANG	S AE NG
SANTA	S AE N T AH
SANTA	S AE N AH
SANTERIA	S AE N T EH R IY AH
SASHES	S AE SH IH Z
SAT	S AE T
SATELLITE	S AE T AH L AY T
SATIN	S AE T AH N
SATISFIED	S AE T AH S F AY D
SATISFIED	S AE T IH S F AY D
SATISFYING	S AE T IH S F AY IH NG
SATURDAY	S AE T ER D IY
SATURDAY	S AE T IH D EY
SAVE	S EY V
SAVED	S EY V D
SAVING	S EY V IH NG
SAVIOR	S EY V Y ER
SAW	S AO
SAY	S EY
SAYING	S EY IH NG
SAYS	S EH Z
SAYS	S IH Z
SCARED	S K EH R D
SCARES	S K EH R Z
SCATTERED	S K AE T ER D
SCENE	S IY N
SCENT	S EH N T
SCHNITZEL	S K N IH T S AH L
SCHOOL	S K UW L
SCISSORS	S IH Z ER Z
SCOOTCH	S K UW CH
SCRATCH	S K R AE CH
SCREAM	S K R IY M
SCREAMED	S K R IY M D
SCREAMING	S K R IY M IH NG
SCULPTOR	S K AH L P T ER
SEA	S IY
SEARCH	S ER CH
SEARCHING	S ER CH IH NG
SEASONS	S IY Z AH N Z
SECOND	S EH K AH N D
SECONDS	S EH K AH N D Z
SECRET	S IY K R AH T
SECRET	S IY K R IH T
SECRETS	S IY K R IH T S
SEE	S IY
SEEING	S IY IH NG
SEEK	S IY K
SEEM	S IY M
SEEMS	S IY M Z
SEEN	S IY N
SELECTION	S AH L EH K SH AH N
SELF	S EH L F
SELFISH	S EH L F IH SH
SELL	S EH L
SEND	S EH N D
SENDING	S EH N D IH NG
SENSE	S EH N S
SENSES	S EH N S IH Z
SEPARATE	S EH P ER EY T
SEPARATE	S EH P ER IH T
SEPARATE	S EH P R AH T
SERIOUS	S IH R IY AH S
SERVICE	S ER V AH S
SERVICE	S ER V IH S
SET	S EH T
SETTLE	S EH T AH L
SETTLES	S EH T AH L Z
SEVEN	S EH V AH N
SEW	S OW
SEX	S EH K S
SEXY	S EH K S IY
SHA	SH AA
SHADOW	SH AE D OW
SHADOWS	SH AE D OW Z
SHAKE	SH EY K
SHAKEN	SH EY K AH N
SHALL	SH AE L
SHAME	SH EY M
SHAPE	SH EY P
SHARE	SH EH R
SHARING	SH EH R IH NG
SHARPEST	SH AA R P AH S T
SHE	SH IY
SHE'LL	SH IY L
SHE'S	SH IY Z
SHED	SH EH D
SHERIFF	SH EH R AH F
SHERIFF	SH EH R IH F
SHHH	EH S EY CH EY CH
SHIMMERING	SH IH M ER IH NG
SHINE	SH AY N
SHINES	SH AY N Z
SHINING	SH AY N IH NG
SHINY	SH AY N IY
SHIPS	SH IH P S
SHIRT	SH ER T
SHOE	SH UW
SHOES	SH UW Z
SHOOK	SH UH K
SHOOTING	SH UW T IH NG
SHOPPING	SH AA P IH NG
SHORT	SH AO R T
SHOT	SH AA T
SHOTS	SH AA T S
SHOULD	SH UH D
SHOULD'VE	SH UH D AH V
SHOUT	SH AW T
SHOUTS	SH AW T S
SHOW	SH OW
SHOWED	SH OW D
SHOWING	SH OW IH NG
SHOWS	SH OW Z
SHUFFLES	SH AH F AH L Z
SHY	SH AY
SICK	S IH K
SIDE	S AY D
SIDEWALK	S AY D W AO K
SIDEWAYS	S AY D W EY Z
SIGHT	S AY T
SIGHTS	S AY T S
SIGNS	S AY N Z
SILENCE	S AY L AH N S
SILVER	S IH L V ER
SIMPLE	S IH M P AH L
SIMPLY	S IH M P L IY
SIN	S IH N
SINCE	S IH N S
SINCERITY	S IH N S EH R AH T IY
SING	S IH NG
SINGING	S IH NG IH NG
SINGLE	S IH NG G AH L
SINGS	S IH NG Z
SINK	S IH NG K
SINS	S IH N Z
SIP	S IH P
SIPPING	S IH P IH NG
SISTER	S IH S T ER
SIT	S IH T
SITTING	S IH T IH NG
SITUATION	S IH CH UW EY SH AH N
SIX	S IH K S
SIXTY	S IH K S T IY
SIZE	S AY Z
SIZZLING	S IH Z AH L IH NG
SIZZLING	S IH Z L IH NG
SKATE	S K EY T
SKIES	S K AY Z
SKIN	S K IH N
SKIP	S K IH P
SKIZER	S K AY Z AH R
SKY	S K AY
SLAP	S L AE P
SLAVE	S L EY V
SLEEP	S L IY P
SLEEPING	S L IY P IH NG
SLEEPS	S L IY P S
SLEIGH	S L EY
SLEPT	S L EH P T
SLIP	S L IH P
SLIPPING	S L IH P IH NG
SLOB	S L AA B
SLOW	S L OW
SLOWLY	S L OW L IY
SMACK	S M AE K
SMALL	S M AO L
SMART	S M AA R T
SMELLED	S M EH L D
SMELLS	S M EH L Z
SMILE	S M AY L
SMILES	S M AY L Z
SMILING	S M AY L IH NG
SMOKE	S M OW K
SMOKING	S M OW K IH NG
SMOOTH	S M UW DH
SNAP	S N AE P
SNARE	S N EH R
SNATCHING	S N AE CH IH NG
SNOW	S N OW
SNOWFLAKES	S N OW F L EY K S
SNOWING	S N OW IH NG
SNUGGIE	S N AH G IY
SO	S OW
SOARING	S AO R IH NG
SOCIAL	S OW SH AH L
SOFTER	S AA F T ER
SOFTER	S AO F T ER
SOLD	S OW L D
SOLDIER	S OW L JH ER
SOME	S AH M
SOMEBODY	S AH M B AA D IY
SOMEBODY	S AH M B AH D IY
SOMEBODY'S	S AH M B AA D IY Z
SOMEHOW	S AH M HH AW
SOMEONE	S AH M W AH N
SOMEONE'S	S AH M W AH N Z
SOMETHING	S AH M TH IH NG
SOMETHING'S	S AH M TH IH NG Z
SOMETIMES	S AH M T AY M Z
SOMEWHERE	S AH M W EH R
SON	S AH N
SONG	S AO NG
SONNEZ	S AO N EH
SOON	S UW N
SOONER	S UW N ER
SOOOOMEBODY	S UW AH M EH B AH D IY
SOOTHE	S UW DH
SORRY	S AA R IY
SORT	S AO R T
SOUL	S OW L
SOUND	S AW N D
SOUNDS	S AW N D Z
SOUNDS	S AW N Z
SOUTH	S AW TH
SOUTHERN	S AH DH ER N
SPANGLED	S P AE NG G AH L D
SPARE	S P EH R
SPARKLING	S P AA R K L IH NG
SPARKLING	S P AA R K AH L IH NG
SPEAK	S P IY K
SPEAKING	S P IY K IH NG
SPEND	S P EH N D
SPENDING	S P EH N D IH NG
SPENT	S P EH N T
SPEWING	S P Y UW IH NG
SPIN	S P IH N
SPINNING	S P IH N IH NG
SPIT	S P IH T
SPITE	S P AY T
SPLENDID	S P L EH N D IH D
SPOT	S P AA T
SPOTLESS	S P AA T L AH S
SPOTLIGHT	S P AA T L AY T
SPREAD	S P R EH D
SPREADING	S P R EH D IH NG
SPRING	S P R IH NG
SPRING	S P ER IH NG
SQUARE	S K W EH R
STAAAAAAAND	S T AA AA AH AH N D
STACK	S T AE K
STAIRS	S T EH R Z
STAND	S T AE N D
STANDING	S T AE N D IH NG
STANDS	S T AE N D Z
STAR	S T AA R
STARBUCKS	S T AA R B AH K S
STARE	S T EH R
STARED	S T EH R D
STARING	S T EH R IH NG
STARS	S T AA R Z
STARSTRUCK	S T AA R S T R AH K
START	S T AA R T
STARTED	S T AA R T AH D
STARTED	S T AA R T IH D
STARTING	S T AA R T IH NG
STATED	S T EY T IH D
STAY	S T EY
STAYED	S T EY D
STEAL	S T IY L
STEALS	S T IY L Z
STEAM	S T IY M
STEEL	S T IY L
STEP	S T EH P
STIC	S T IH K
STICK	S T IH K
STILL	S T IH L
STING	S T IH NG
STINGS	S T IH NG Z
STOCK	S T AA K
STOLE	S T OW L
STOLEN	S T OW L AH N
STONE	S T OW N
STONED	S T OW N D
STONES	S T OW N Z
STOOP	S T UW P
STOP	S T AA P
STORIES	S T AO R IY Z
STORY	S T AO R IY
STRAIGHT	S T R EY T
STRAIN	S T R EY N
STRANGE	S T R EY N JH
STRANGER	S T R EY N JH ER
STRAY	S T R EY
STREAMING	S T R IY M IH NG
STREET	S T R IY T
STREETS	S T R IY T S
STRENGTH	S T R EH NG K TH
STRENGTH	S T R EH NG TH
STRIFE	S T R AY F
STRIKE	S T R AY K
STRINGS	S T R IH NG Z
STRIPES	S T R AY P S
STROLLING	S T R OW L IH NG
STRONG	S T R AO NG
STRUDEL	S T R UW D AH L
STRUGGLED	S T R AH G AH L D
STRUGGLES	S T R AH G AH L Z
STRUMMED	S T R AH M D
STRUT	S T R AH T
STUCK	S T AH K
STUFF	S T AH F
STUMBLE	S T AH M B AH L
STYLE	S T AY L
SU	S AH
SUBWAY	S AH B W EY
SUCCEED	S AH K S IY D
SUCH	S AH CH
SUCKS	S AH K S
SUDDENLY	S AH D AH N L IY
SUFFER	S AH F ER
SUFFOCATE	S AH F AH K EY T
SUIT	S UW T
SUMMER	S AH M ER
SUMMERTIME	S AH M ER T AY M
SUN	S AH N
SUN'S	S AH N Z
SUNG	S AH NG
SUNLIGHT	S AH N L AY T
SUNSET	S AH N S EH T
SUNSETS	S AH N S EH T S
SUNSHINE	S AH N SH AY N
SUPERFICIAL	S UW P ER F IH SH AH L
SUPERMAN	S UW P ER M AH N
SUPERMAN	S UW P ER M AE N
SUPPOSED	S AH P OW Z D
SURE	SH UH R
SURPRISE	S ER P R AY Z
SURPRISE	S AH P R AY Z
SURPRISED	S ER P R AY Z D
SURPRISED	S AH P R AY Z D
SURPRISES	S ER P R AY Z IH Z
SURPRISES	S AH P R AY Z IH Z
SURROUNDED	S ER AW N D AH D
SURROUNDED	S ER AW N D IH D
SURVIVE	S ER V AY V
SWAG	S W AE G
SWALLOW	S W AA L OW
SWALLOW	S W AO L OW
SWALLOWED	S W AA L OW D
SWAT	S W AA T
SWEAR	S W EH R
SWEAT	S W EH T
SWEATER	S W EH T ER
SWEEPING	S W IY P IH NG
SWEET	S W IY T
SWEETER	S W IY T ER
SWEETEST	S W IY T AH S T
SWELL	S W EH L
SWIM	S W IH M
SWIMMING	S W IH M IH NG
SWING	S W IH NG
SWINGING	S W IH NG IH NG
SWORE	S W AO R
SYMPHONY	S IH M F AH N IY
T	T IY
TAKE	T EY K
TAKEN	T EY K AH N
TAKES	T EY K S
TAKING	T EY K IH NG
TALE	T EY L
TALES	T EY L Z
TALK	T AO K
TALKING	T AO K IH NG
TALL	T AO L
TAN	T AE N
TANNED	T AE N D
TASTE	T EY S T
TAY	T EY
TE	T IY
TEACH	T IY CH
TEAR	T EH R
TEAR	T IH R
TEARING	T EH R IH NG
TEARING	T IH R IH NG
TEARS	T EH R Z
TEARS	T IH R Z
TEASED	T IY Z D
TELEPHONE	T EH L AH F OW N
TELL	T EH L
TELLING	T EH L IH NG
TEMPER'S	T EH M P ER Z
TEMPERATURE	T EH M P R AH CH ER
TEMPERATURE	T EH M P ER AH CH ER
TEN	T EH N
TENNESSEE	T EH N AH S IY
TEST	T EH S T
TEXAS	T EH K S AH S
THAN	DH AE N
THAN	DH AH N
THANK	TH AE NG K
THANKS	TH AE NG K S
THAT	DH AE T
THAT	DH AH T
THAT'LL	DH AE T AH L
THAT'S	DH AE T S
THE	DH AH
THE	DH IY
THEIR	DH EH R
THEM	DH EH M
THEM	DH AH M
THEN	DH EH N
THERE	DH EH R
THERE'LL	DH EH R AH L
THERE'S	DH EH R Z
THESE	DH IY Z
THEY	DH EY
THEY'LL	DH EH L
THEY'RE	DH EH R
THEY'VE	DH EY V
THICK	TH IH K
THIEF	TH IY F
THIN	TH IH N
THING	TH IH NG
THINGABOBS	TH IH NG AH B AA B Z
THINGS	TH IH NG Z
THINK	TH IH NG K
THINKING	TH IH NG K IH NG
THINKS	TH IH NG K S
THIRTEEN	TH ER T IY N
THIRTY	TH ER D IY
THIS	DH IH S
THOSE	DH OW Z
THOU	DH AW
THOUGH	DH OW
THOUGHT	TH AO T
THOUGHT'S	TH AO TS
THOUSAND	TH AW Z AH N D
THOUSAND	TH AW Z AH N
THREE	TH R IY
THREW	TH R UW
THRILL	TH R IH L
THRILLING	TH R IH L IH NG
THROAT	TH R OW T
THROUGH	TH R UW
THROUGHOUT	TH R UW AW T
THROW	TH R OW
THUMB	TH AH M
THUNDER	TH AH N D ER
THY	DH AY
TI	T IY
TICKET	T IH K AH T
TICKET	T IH K IH T
TICKING	T IH K IH NG
TICKS	T IH K S
TIDAL	T AY D AH L
TIDE	T AY D
TIDES	T AY D Z
TIE	T AY
TIED	T AY D
TIFFANNY'S	T IH F AE N AH Z
TIFFANY'S	T IH F AH N IY Z
TIGHT	T AY T
TILL	T IH L
TIME	T AY M
TIMES	T AY M Z
TIPS	T IH P S
TIRE	T AY ER
TIRED	T AY ER D
TO	T UW
TO	T IH
TO	T AH
TOASTED	T OW S T IH D
TODAY	T AH D EY
TODAY	T UW D EY
TOES	T OW Z
TOGETHER	T AH G EH DH ER
TOLD	T OW L D
TOMORROW	T AH M AA R OW
TOMORROW	T UW M AA R OW
TONE	T OW N
TONGUE	T AH NG
TONIC	T AA N IH K
TONIGHT	T AH N AY T
TONIGHT	T UW N AY T
TONIGHT'S	T AH N AY T S
TONIGHT'S	T UW N AY T S
TONIIIGHT	T OW N IY AY T
TOO	T UW
TOO'	T UW
TOOK	T UH K
TOOL	T UW L
TOOOO	T UW UW
TOP	T AA P
TOP	T AO P
TORN	T AO R N
TORNADO	T AO R N EY D OW
TOSSED	T AO S T
TOUCH	T AH CH
TOWER	T AW ER
TOWN	T AW N
TOXIC	T AA K S IH K
TOY	T OY
TRACK	T R AE K
TRADE	T R EY D
TRAGEDY	T R AE JH AH D IY
TRAIL	T R EY L
TRAIN	T R EY N
TRAINS	T R EY N Z
TRANSGENDERED	T R AE N S JH EH N D ER D
TRASH	T R AE SH
TRASHED	T R AE SH T
TRAVALING	T R AH V EY L AH NG
TRAVEL	T R AE V AH L
TREASURE	T R EH ZH ER
TREASURES	T R EH ZH ER Z
TREAT	T R IY T
TREE	T R IY
TREES	T R IY Z
TREMBLING	T R EH M B AH L IH NG
TREMBLING	T R EH M B L IH NG
TRIED	T R AY D
TRIES	T R AY Z
TRILLION	T R IH L Y AH N
TRIP	T R IH P
TROUBLE	T R AH B AH L
TROUBLES	T R AH B AH L Z
TROUBLESOME	T R AH B AH L S AH M
TROVE	T R OW V
TRUCK	T R AH K
TRUCKS	T R AH K S
TRUE	T R UW
TRUELY	T R UW L IY
TRULY	T R UW L IY
TRUTH	T R UW TH
TRUTHS	T R UW TH S
TRY	T R AY
TRYING	T R AY IH NG
TRYING	T R AY NG
TRYNA'	T R IH N AH
TRYYY	T R AY IY
TUCKER	T AH K ER
TUMBLE	T AH M B AH L
TUMBLING	T AH M B AH L IH NG
TUNE	T UW N
TURN	T ER N
TURNED	T ER N D
TURNING	T ER N IH NG
TURNS	T ER N Z
TV	T IY V IY
TV	T EH L AH V IH ZH AH N
TWELVE	T W EH L V
TWENTY	T W EH N T IY
TWICE	T W AY S
TWILIGHT	T W AY L AY T
TWILIGHT'S	T W AY L AY TS
TWIST	T W IH S T
TWISTY	T W IH S T IY
TWO	T UW
TYPE	T AY P
U	Y UW
UH	AH
UMBRELLA	AH M B R EH L AH
UNBEARABLE	AH N B EH R AH B AH L
UNBELIEVABLE	AH N B AH L IY V AH B AH L
UNCONDITIONAL	AH N K AH N D IH SH AH N AH L
UNDER	AH N D ER
UNDERGROUND	AH N D ER G R AW N D
UNDERNEATH	AH N D ER N IY TH
UNDERSTAND	AH N D ER S T AE N D
UNDONE	AH N D AH N
UNEMPLOYMENT	AH N IH M P L OY M AH N T
UNEXPECTEDLY	AH N IH K S P EH K T IH D L IY
UNFORGIVABLE	AH N F AO R G IH V AH B AH L
UNHAPPY	AH N HH AE P IY
UNIVERSE	Y UW N AH V ER S
UNKIND	AH N K AY N D
UNKNOWN	AH N N OW N
UNNOTICED	AH N N OW T IH S T
UNSPOKEN	AH N S P OW K AH N
UNTIL	AH N T IH L
UNTOLD	AH N T OW L D
UP	AH P
UPHILL	AH P HH IH L
UPON	AH P AA N
US	AH S
US	Y UW EH S
USA	Y UW EH S EY
USE	Y UW S
USE	Y UW Z
USED	Y UW Z D
V	V IY
VAGABOND	V AE G AH B AA N D
VALERIE	V AE L ER IY
VANITIES	V AE N AH T IY Z
VENOM	V EH N AH M
VERSES	V ER S IH Z
VERY	V EH R IY
VIBE	V AY B
VICES	V AY S AH Z
VICES	V AY S IH Z
VIEW	V Y UW
VINE	V AY N
VIRTUE	V ER CH UW
VOICE	V OY S
VOLCANO	V AA L K EY N OW
VOLE	V AO L EH
VOUS	V UW
WA	W AA
WAIT	W EY T
WAITED	W EY T IH D
WAITING	W EY T IH NG
WAITRESS	W EY T R AH S
WAKE	W EY K
WAKING	W EY K IH NG
WALK	W AO K
WALK	W AA K
WALKED	W AO K T
WALKING	W AO K IH NG
WALKS	W AO K S
WALLS	W AO L Z
WAN	W AA N
WANDERING	W AA N D ER IH NG
WANNA	W AA N AH
WANT	W AA N T
WANT	W AO N T
WANTED	W AO N T IH D
WANTS	W AA N T S
WANTS	W AO N T S
WAR	W AO R
WARM	W AO R M
WARNING	W AO R N IH NG
WAS	W AA Z
WASN'T	W AA Z AH N T
WASN'T	W AH Z AH N T
WASTING	W EY S T IH NG
WATCH	W AA CH
WATCH	W AO CH
WATCHED	W AA CH T
WATCHED	W AO CH T
WATCHING	W AA CH IH NG
WATER	W AO T ER
WATER'S	W AO T ER Z
WATERS	W AO T ER Z
WAVE	W EY V
WAVES	W EY V Z
WAY	W EY
WAYS	W EY Z
WE	W IY
WE'D	W IY D
WE'LL	W IY L
WE'LL	W IH L
WE'RE	W IY R
WE'RE	W IH R
WE'RE	W ER
WE'VE	W IY V
WEAK	W IY K
WEAPON	W EH P AH N
WEAR	W EH R
WEATHER	W EH DH ER
WEDDING	W EH D IH NG
WEEKEND	W IY K EH N D
WEEKEND	W IY K IH N D
WEEP	W IY P
WEIGHT	W EY T
WELL	W EH L
WENT	W EH N T
WERE	W ER
WEST	W EH S T
WHAT	W AH T
WHAT	HH W AH T
WHAT'S	W AH T S
WHAT'S	HH W AH T S
WHATEVER	W AH T EH V ER
WHATEVER	HH W AH T EH V ER
WHATZITS	W AA T S AH T S
WHEN	W EH N
WHEN	HH W EH N
WHEN	W IH N
WHEN	HH W IH N
WHEN'S	W EH N Z
WHEN'S	HH W EH N Z
WHENEVER	W EH N EH V ER
WHENEVER	HH W EH N EH V ER
WHERE	W EH R
WHERE	HH W EH R
WHEREVER	W EH R EH V ER
WHEREVER	HH W EH R EH V ER
WHETHER	W EH DH ER
WHETHER	HH W EH DH ER
WHHHHHY	W HH AY
WHHHY	W HH AY
WHICH	W IH CH
WHICH	HH W IH CH
WHILE	W AY L
WHILE	HH W AY L
WHISKERS	W IH S K ER Z
WHISKERS	HH W IH S K ER Z
WHISKEY	W IH S K IY
WHISKEY	HH W IH S K IY
WHISPER	W IH S P ER
WHISPER	HH W IH S P ER
WHISPERS	W IH S P ER Z
WHISPERS	HH W IH S P ER Z
WHITE	W AY T
WHITE	HH W AY T
WHO	HH UW
WHO'LL	HH UW L
WHO'S	HH UW Z
WHOA	W OW
WHOA	HH W OW
WHOA	HH OW
WHOLE	HH OW L
WHOSE	HH UW Z
WHOZITS	W AA Z AH T S
WHY	W AY
WHY	HH W AY
WHY'D	W AY D
WHY'D	HH W AY D
WIDE	W AY D
WIFE	W AY F
WILD	W AY L D
WILL	W IH L
WILL	W AH L
WIN	W IH N
WIND	W AY N D
WIND	W IH N D
WINDMILL	W IH N D M IH L
WINDOW	W IH N D OW
WINDOWS	W IH N D OW Z
WINDPIPE	W IH N D P AY P
WINDS	W IH N D Z
WINDS	W AY N D Z
WINE	W AY N
WINGS	W IH NG Z
WINNING	W IH N IH NG
WINS	W IH N Z
WINTERS	W IH N T ER Z
WIRES	W AY ER Z
WIRES	W AY R Z
WISER	W AY Z ER
WISH	W IH SH
WISHING	W IH SH IH NG
WITH	W IH DH
WITH	W IH TH
WITHIN	W IH DH IH N
WITHIN	W IH TH IH N
WITHOUT	W IH TH AW T
WITHOUT	W IH DH AW T
WO	W UW
WOAH	W OW AH
WOKE	W OW K
WOMAN	W UH M AH N
WOMEN	W IH M AH N
WON	W AH N
WON	W AA N
WON'T	W OW N T
WONDER	W AH N D ER
WONDERFUL	W AH N D ER F AH L
WONDERING	W AH N D ER IH NG
WONDERS	W AH N D ER Z
WONDROUS	W AH N D R AH S
WOO	W UW
WOOLEN	W UH L AH N
WOOO	W UW UW
WOOOAH	W UW OW AH
WORD	W ER D
WORDS	W ER D Z
WORE	W AO R
WORK	W ER K
WORKING	W ER K IH NG
WORKS	W ER K S
WORLD	W ER L D
WORLD'S	W ER L D Z
WORLDS	W ER L D Z
WORRY	W ER IY
WORSE	W ER S
WORST	W ER S T
WORTH	W ER TH
WORTHWHILE	W ER TH W AY L
WOULD	W UH D
WOULDN'T	W UH D AH N T
WOUND	W AW N D
WOUND	W UW N D
WOW	W AW
WRAP	R AE P
WRAPPED	R AE P T
WRITE	R AY T
WRITTEN	R IH T AH N
WRONG	R AO NG
WROTE	R OW T
XBOX	Z B AA K S
XIC	K S IH K
Y'ALL	Y AO L
YA	Y AA
YA'	Y AA
YAH	Y AA
YE	Y IY
YE	Y EH
YEA	Y EY
YEAAAAAH	Y IY AH AH
YEAH	Y AE
YEAR	Y IH R
YEARS	Y IH R Z
YEEEAH	Y IY IY AH
YEEEEEEAAAAH	Y IY IY IY AH AH
YEP	Y EH P
YES	Y EH S
YESTERDAY	Y EH S T ER D EY
YESTERDAY	Y EH S T ER D IY
YESTERDAYS	Y EH S T ER D EY Z
YESTERDAYS	Y EH S T ER D IY Z
YET	Y EH T
YEYEYEAH	Y EY EY IY AH
YO	Y OW
YORK	Y AO R K
YOU	Y UW
YOU'	Y UW
YOU'D	Y UW D
YOU'D	Y UH D
YOU'LL	Y UW L
YOU'RE	Y UH R
YOU'RE	Y UW R
YOU'S	Y UW Z
YOU'VE	Y UW V
YOUNG	Y AH NG
YOUNGER	Y AH NG G ER
YOUR	Y AO R
YOUR	Y UH R
YOURS	Y UH R Z
YOURS	Y AO R Z
YOURS	Y ER Z
YOURSELF	Y ER S EH L F
YOURSELF	Y UH R S EH L F
YOURSELF	Y AO R S EH L F
YOUTH	Y UW TH
ZAINA	Z EY N AH
ZERO	Z IY R OW
ZONE	Z OW N
ZOO	Z UW
